F 220,100,234
C 15,30,200

NO ./textures/koto_north.xpm
SO ./textures/koto_south.xpm
WE ./textures/koto_west.xpm
EA ./textures/koto_east.xpm

        1111111111111111111111111
        1000000000110000000000001
        1011000001110000000000001
        1001000000000000000000001
111111111011000001110000000000001
100000000111000001110111111111111
11110111111111011100000010001
11110111111111011101010010001
110000001101 10111000000100011
1000E000000010001100000010001
10000000000000001101010000001
110000011101010111110111100111
11110111 1110101 101111010001
11111111 1111111 111111111111
