F 300,-10,234
C 256,30,-1

NO ./textures/wall_north.xpm
SO ./textures/wall_south.xpm
WE ./textures/wall_west.xpm
EA ./textures/wall_east.xpm

        1111111111111111111111111
        1000000000110000000000001
       1011000001110000000000001
        1001000000000000000000001
111111111011000001110000000000001
100000000111000001110111111111111
11110111111111011100000010001
11110111111111011101010010001
110000001101 0011100000010001001
10000000000010001100000010001
10000000000000001101010010001
11000001110101011111011110N0111
11110111 1110101 101111010001
11111111 1111111 111111111111
